Abhishek	Agarwal	1
Taylor Austin	Arnold	3
Raegan Rose	Arnold	4
Elena Ruth	Ball	5
Joseph Francis	Barr	4
Michael Rei	Beiley	8
Louis Joseph	Bertani	7
Nate Hunter	Brill	4
Darren Keith	Chin	5
Austin Nicholas	Conry	6
Maxwell Cody	Critchfield	7
Cameron Matthew	Crowley	9
America Darling	Curl	6
Paul Matthew	Drust	4
Alejandro	Durazo	2
Julia Macil Calara	English	8
Brandon Scott	Erickson	6
Lauren Marie	Esham	9
Javier Alejandro	Frausto	2
Spencer James	Gantt	5
Héctor Alejandro	Garavito Lopez	6
Alana Gabrielle	Gonzales	7
Chelsea Margaret	Gorius	1
Miranda Nicole	Hampton	9
Kale Ethan	Henning	7
Nathan Earl	Hester	4
Cameron James	Horn	6
Brandon Chang-Lee	Kaplan	7
Gabriel Michael Raphael	Klein	6
Alyssa Rae	Klix	8
Justin Christopher	Koehler	9
Zachary Bruce	Kozak	4
Zachary Austin	Kraimer	3
Nathan Ryan	Kunch	3
Cameron Jonathon	Kurz	5
Christian Arleigh	Larson	6
Arjun Zarzuela	Lathi	7
Madison May	Lomax	7
Shane Christopher	Longbrake	7
Laura Diane	Lundsten	8
Saul Jose	Manzano	3
Jason Joseph	Marquez 	3
Juan Carlos	Martinez Favela	4
Isabella	Martinez-Lugo	5
Miranda Abigail	Mast	8
Clayton Edward	Matheson	8
Lauren Kate	McBeth	2
Connor Justin Joseph	Musick	2
Chase Alexander	Musick	1
Jonathan Alan	Musser	1
Hernan	Oviedo	5
Noah Jaeger	Parkins	6
Austin James	Parslow	7
Jacob Laurence	Phelps	4
Daniel Thomas	Phillips	6
William Cameron	Reynolds	7
Anthony Sergio	Salazar	5
Mitchell Anthony	Sardo	7
Benjamin David	Sawyer	8
Kayla Marina	Scaramella	5
Ryan Earl	Schnitzler	3
Aadi	Sharma	6
Phillip Thomas	Shelton	6
Brynne Maryna	Skoropys	4
Grant Drake	Sugaski	8
Jorge Armando	Sugich Prandini	5
Noah Theodore	Thomsen	3
Taylor Grant	Thomson	6
David Michael	Tousley	6
Martin Junior	Valencia	3
Zachary Alan	Walker	5
Han	Wang	6
Nicole Renae	Wigtil 	4
Alexa McKenna	Wilder	4
Taylor Michele	Williams	7
Tennyson James	Wilson	5
Jacob Nathaniel	Zall	3
Ryan Stephen	Zenhausern	5